28 16 
0 1 2 0 0 0 0 0 0 0 0 0 0 0 0 0 0 0 1 2 0 0 0 0 1 2 0 0
4 5 6 4 4 4 4 4 4 4 4 4 4 4 4 4 4 4 5 6 4 4 4 4 5 2 0 0
8 9 10 8 8 8 8 8 8 8 8 8 8 8 8 8 8 8 9 10 8 8 8 8 9 2 0 0
0 1 2 0 0 0 0 0 0 0 0 0 0 0 0 0 0 0 1 2 0 0 0 0 1 2 0 0
0 1 2 0 0 0 0 0 0 0 0 0 0 0 0 0 0 0 1 2 0 0 0 0 1 2 0 0
0 1 2 0 0 0 0 0 0 0 0 0 0 0 0 0 0 0 1 2 0 0 0 0 1 2 0 0
4 5 6 4 4 4 4 4 4 4 4 4 4 4 4 4 4 4 5 6 4 4 4 4 5 6 4 4
8 9 10 8 8 8 8 8 8 8 9 10 8 8 8 8 8 8 8 8 8 8 8 8 8 8 8 8
0 1 2 0 0 0 0 0 0 0 1 2 0 0 0 0 0 0 0 0 0 0 0 0 0 0 0 0  
0 1 2 0 0 0 0 0 0 0 1 2 0 0 0 0 0 0 0 0 0 0 0 0 0 0 0 0
0 1 2 0 0 0 0 0 0 0 1 2 0 0 0 0 0 0 0 0 0 0 0 0 0 0 0 0
0 1 2 0 0 0 0 0 0 0 1 2 0 0 0 0 0 0 0 0 0 0 0 0 0 0 0 0
4 5 6 4 4 4 4 4 4 4 5 6 4 4 4 4 4 4 4 4 4 4 4 4 4 4 4 4
8 9 10 8 8 8 8 8 8 8 8 8 8 8 8 8 8 8 8 8 9 10 8 8 8 8 8 8
0 1 2 0 0 0 0 0 0 0 0 0 0 0 0 0 0 0 0 0 1 2 0 0 0 0 0 0
0 1 2 0 0 0 0 0 0 0 0 0 0 0 0 0 0 0 0 0 1 2 0 0 0 0 0 0 